{
    "level":999,
    "stage_name": "debug_map_1",
    "enemy_count": 99,
    "powerup_req": 9999,
    "tutorial": 999,
    "map": [
        [2,2,2,2,0,0,0,0,0,0,8,8,8,8,8,0,0,0,0,0,0,2,2,2,2],
        [2,2,2,2,0,0,0,0,0,0,0,8,8,8,0,0,0,0,0,0,0,2,2,2,2],
        [2,2,5,5,5,0,0,0,0,0,0,0,8,0,0,0,0,0,0,0,5,5,5,2,2],
        [2,2,5,6,5,0,0,0,0,0,0,0,0,0,0,0,0,0,0,0,5,7,5,2,2],
        [0,0,5,5,5,0,0,0,0,0,0,4,0,4,0,0,0,0,0,0,5,5,5,0,0],
        [0,0,0,0,0,0,0,0,0,9,9,4,0,4,9,9,0,0,0,0,0,0,0,0,0],
        [8,0,0,0,0,0,0,0,0,9,9,4,0,4,9,9,0,0,0,0,0,0,0,0,8],
        [8,8,0,0,0,0,0,0,4,4,4,4,0,4,4,4,4,0,0,0,0,0,0,8,8],
        [8,8,8,0,0,0,0,0,0,0,0,0,1,0,0,0,0,0,0,0,0,0,8,8,8],
        [8,8,0,0,0,0,0,0,4,4,4,4,0,4,4,4,4,0,0,0,0,0,0,8,8],
        [8,0,0,0,0,0,0,0,0,9,9,4,0,4,9,9,0,0,0,0,0,0,0,0,8],
        [0,0,0,0,0,0,0,0,0,9,9,4,0,4,9,9,0,0,0,0,0,0,0,0,0],
        [2,2,5,5,5,0,0,0,0,0,0,4,0,4,0,0,0,0,0,0,5,5,5,0,0],
        [2,2,5,7,5,0,0,0,0,0,0,0,0,0,0,0,0,0,0,0,5,6,5,2,2],
        [2,2,5,5,5,0,0,0,0,0,0,0,8,0,0,0,0,0,0,0,5,5,5,2,2],
        [2,2,2,2,0,0,0,0,0,0,0,8,8,8,0,0,0,0,0,0,0,2,2,2,2],
        [2,2,2,2,0,0,0,0,0,0,8,8,8,8,8,0,0,0,0,0,0,2,2,2,2]
    ]
}