{
    "level":13,
    "stage_name": "Mazed",
    "enemy_count": 25,
    "powerup_req": 2300,
    "tutorial": 0,
    "map": [
        [0,0,0,0,0,0,0,0,0,0,2,0,4,0,0,0,0,0,0,0,0,0,2,0,0],
        [0,2,0,0,0,0,0,0,0,0,0,0,4,0,0,0,0,0,0,0,0,0,0,0,0],
        [0,0,4,4,4,4,4,4,4,4,9,9,4,0,0,4,4,4,4,0,0,0,4,0,0],
        [0,0,5,0,0,0,0,0,0,4,0,0,4,0,0,4,0,0,5,0,0,0,4,0,0],
        [0,0,5,0,0,0,0,0,2,4,9,9,4,2,0,4,2,0,5,0,0,0,4,0,0],
        [9,9,4,4,4,4,4,9,9,4,0,0,4,4,4,4,4,4,4,4,4,4,4,0,0],
        [0,0,0,2,0,0,0,0,0,4,9,9,5,0,0,0,0,0,0,0,0,2,0,0,0],
        [0,0,0,0,0,0,0,0,0,4,0,0,5,0,0,0,0,0,0,0,0,0,0,0,0],
        [0,0,4,4,4,4,4,5,5,4,9,9,4,4,4,2,2,4,4,4,4,4,4,9,9],
        [2,0,4,2,0,0,0,0,0,4,0,0,4,0,0,0,0,4,0,0,4,0,2,0,0],
        [0,0,4,0,0,0,0,0,0,4,9,9,4,0,0,0,0,4,0,0,4,0,0,0,0],
        [0,0,4,0,0,4,4,4,4,4,0,0,4,5,5,4,4,4,5,5,4,4,4,0,0],
        [0,0,4,0,0,0,0,0,0,0,0,0,4,0,0,0,0,0,0,0,0,0,0,0,0],
        [0,0,4,0,0,0,0,0,0,0,0,2,4,0,0,0,0,2,0,0,0,0,0,2,2],
        [5,5,4,4,4,4,4,4,4,4,4,4,4,4,4,4,4,4,4,4,4,4,4,5,5],
        [0,0,0,0,0,0,0,0,0,0,0,5,5,5,0,0,0,0,0,0,0,0,0,0,0],
        [0,0,0,0,0,0,0,0,0,0,1,5,3,5,0,0,0,0,0,0,0,0,0,0,0]
    ]
}