{
    "level":4,
    "stage_name": "Mirror",
    "enemy_count": 10,
    "powerup_req": 1100,
    "tutorial": 4,
    "map": [
        [2,2,2,2,2,2,2,2,2,2,2,2,2,2,2,2,2,2,2,2,2,2,2,2,2],
        [2,2,2,2,2,2,2,2,2,2,2,2,2,2,2,2,2,2,2,2,2,2,2,2,2],
        [0,0,0,0,0,0,0,0,0,0,0,0,0,0,0,0,0,0,0,0,0,0,0,0,0],
        [7,0,0,0,0,0,0,0,0,0,0,6,4,7,0,0,0,0,0,0,0,0,0,0,6],
        [4,7,0,0,0,0,0,0,0,0,0,4,4,4,0,0,0,0,0,0,0,0,0,6,4],
        [4,4,7,0,0,0,0,0,0,0,0,7,4,6,0,0,0,0,0,0,0,0,6,4,4],
        [4,4,4,7,0,0,0,0,0,0,0,0,0,0,0,0,0,0,0,0,0,6,4,4,4],
        [4,4,4,4,7,0,0,0,0,0,0,0,0,0,0,0,0,0,0,0,6,4,4,4,4],
        [4,4,4,4,4,0,0,0,0,0,0,0,3,1,0,0,0,0,0,0,4,4,4,4,4],
        [4,4,4,4,6,0,0,0,0,0,0,0,0,0,0,0,0,0,0,0,7,4,4,4,4],
        [4,4,4,6,0,0,0,0,0,0,0,0,0,0,0,0,0,0,0,0,0,7,4,4,4],
        [4,4,6,0,0,0,0,0,0,0,0,6,4,7,0,0,0,0,0,0,0,0,7,4,4],
        [4,6,0,0,0,0,0,0,0,0,0,4,4,4,0,0,0,0,0,0,0,0,0,7,4],
        [6,0,0,0,0,0,0,0,0,0,0,7,4,6,0,0,0,0,0,0,0,0,0,0,7],
        [0,0,0,0,0,0,0,0,0,0,0,0,0,0,0,0,0,0,0,0,0,0,0,0,0],
        [2,2,2,2,2,2,2,2,2,2,2,2,2,2,2,2,2,2,2,2,2,2,2,2,2],
        [2,2,2,2,2,2,2,2,2,2,2,2,2,2,2,2,2,2,2,2,2,2,2,2,2]
    ]
}