{
    "level":10,
    "stage_name": "Forest Battle",
    "enemy_count": 25,
    "powerup_req": 2300,
    "tutorial": 0,
    "map": [
        [4,4,4,2,2,2,2,2,2,2,2,2,2,2,2,2,2,2,2,2,2,2,4,4,4],
        [4,6,8,2,2,2,2,2,2,2,2,2,2,2,2,2,2,2,2,2,2,2,8,7,4],
        [4,8,4,2,2,2,2,2,2,2,2,2,2,2,2,2,2,2,2,2,2,2,4,8,4],
        [8,8,8,9,9,9,9,9,9,9,9,9,9,9,9,9,9,9,9,9,9,9,8,8,8],
        [8,8,8,9,9,9,9,4,8,5,0,0,0,0,0,5,8,4,9,9,9,9,8,8,8],
        [8,8,8,8,9,9,9,9,8,5,4,4,0,0,0,5,8,9,9,9,9,8,8,8,8],
        [8,8,8,9,9,9,9,9,8,5,0,0,0,0,0,5,8,9,9,9,9,9,8,8,8],
        [8,8,8,9,9,4,9,9,8,5,0,0,0,4,4,5,8,9,9,9,4,9,8,8,8],
        [8,8,8,9,9,9,9,9,8,5,0,0,0,0,0,5,8,9,9,9,9,9,8,8,8],
        [8,8,8,4,8,9,9,4,8,5,4,4,0,0,0,5,8,4,9,9,8,4,8,8,8],
        [8,8,8,9,9,9,9,9,8,5,0,0,0,0,0,5,8,9,9,9,9,9,8,8,8],
        [8,8,8,9,9,9,9,9,8,5,0,0,0,4,4,5,8,9,9,9,9,9,8,8,8],
        [8,8,8,8,9,9,9,4,8,5,0,0,0,0,0,5,8,4,9,9,9,8,8,8,8],
        [8,8,8,9,9,9,9,9,9,9,0,0,1,0,0,9,9,9,9,9,9,9,8,8,8],
        [4,8,4,9,9,9,9,5,5,9,5,5,5,5,5,9,5,5,9,9,9,9,4,8,4],
        [4,7,8,9,9,9,9,5,6,9,5,5,5,5,5,9,7,5,9,9,9,9,8,6,4],
        [4,4,4,9,9,9,9,9,9,9,5,5,3,5,5,9,9,9,9,9,9,9,4,4,4]
    ]
}