{
    "level":6,
    "stage_name": "Forest",
    "enemy_count": 15,
    "powerup_req": 1600,
    "tutorial": 5,
    "map": [
        [2,2,2,2,2,2,2,2,2,2,2,2,2,2,2,2,2,2,2,2,2,2,2,2,2],
        [2,2,2,2,2,2,2,2,2,2,2,2,2,2,2,2,2,2,2,2,2,2,2,2,2],
        [9,9,9,9,9,9,9,9,9,9,9,9,5,5,9,9,9,9,9,9,9,9,9,9,9],
        [9,9,9,9,9,9,9,9,9,9,9,9,9,9,9,9,9,9,9,9,9,4,9,9,9],
        [9,9,9,5,5,9,9,9,9,9,9,5,9,9,4,8,8,8,9,9,9,9,4,4,9],
        [8,8,9,9,9,9,9,9,9,9,9,5,9,9,4,8,8,8,9,9,9,9,9,9,9],
        [8,8,9,9,9,9,9,9,9,9,9,9,9,9,4,8,8,8,9,9,5,5,5,9,4],
        [8,8,9,9,9,9,9,9,9,9,9,0,0,0,9,9,9,9,9,9,9,5,5,9,4],
        [9,9,9,9,9,9,9,9,9,9,9,0,3,1,9,9,9,9,4,4,9,9,9,9,9],
        [9,9,4,9,9,9,9,5,5,5,9,0,0,0,9,9,8,8,4,9,5,9,5,5,9],
        [9,9,4,9,9,8,8,9,9,9,9,9,4,9,9,8,8,8,8,9,9,9,5,9,9],
        [9,9,4,9,8,8,8,9,9,9,9,9,4,9,9,9,8,8,8,9,9,9,9,9,9],
        [9,9,9,9,9,9,9,9,9,9,9,9,9,9,9,9,9,9,9,9,9,9,9,5,4],
        [9,9,9,9,9,9,9,9,9,9,9,9,9,9,9,9,9,9,9,9,9,9,5,5,9],
        [9,9,9,9,9,9,9,9,4,4,4,9,9,9,9,9,9,5,5,5,9,9,9,9,9],
        [2,2,2,2,2,2,2,2,2,2,2,2,2,2,2,2,2,2,2,2,2,2,2,2,2],
        [2,2,2,2,2,2,2,2,2,2,2,2,2,2,2,2,2,2,2,2,2,2,2,2,2]
    ]
}