{
    "level":14,
    "stage_name": "Skull Island",
    "enemy_count": 25,
    "powerup_req": 2480,
    "tutorial": -1,
    "map": [
        [4,5,0,0,0,0,0,0,0,0,0,2,2,2,0,0,0,0,0,0,0,0,0,5,4],
        [5,0,0,5,0,0,0,0,0,0,9,9,8,8,8,0,0,0,0,0,0,5,0,0,5],
        [0,0,5,5,0,0,0,0,9,9,8,8,8,8,8,8,8,0,0,0,0,5,5,0,0],
        [0,0,5,0,0,0,0,9,8,8,8,8,8,8,8,8,8,8,0,0,0,0,5,0,0],
        [0,5,5,0,2,0,0,9,8,8,8,8,8,8,8,8,8,8,0,0,2,0,5,5,0],
        [0,5,0,0,0,0,0,9,8,4,4,8,8,8,4,4,8,8,0,0,0,0,0,5,0],
        [0,5,0,0,0,0,9,8,4,4,4,8,8,8,4,4,4,8,8,0,0,0,0,5,0],
        [0,5,5,0,0,0,9,8,4,4,4,8,8,8,4,4,4,8,8,0,0,0,5,5,0],
        [0,5,5,0,0,0,9,8,8,4,8,8,8,8,8,4,8,8,8,0,0,0,5,5,0],
        [0,5,5,0,2,0,9,8,8,8,8,8,4,8,8,8,8,8,8,0,2,0,5,5,0],
        [0,5,5,5,0,0,0,9,8,8,8,4,4,4,8,8,8,8,0,0,0,5,5,5,0],
        [0,0,5,5,5,0,0,0,9,8,8,4,8,4,8,8,8,0,0,0,5,5,5,0,0],
        [0,0,5,5,5,0,0,0,0,9,8,8,8,8,8,8,0,0,0,0,5,5,5,0,0],
        [0,0,0,5,5,5,0,0,0,9,8,8,8,4,8,8,0,0,0,5,5,5,0,0,0],
        [0,0,0,5,5,5,5,0,0,9,8,4,8,4,8,8,0,0,5,5,5,5,0,0,0],
        [5,0,0,0,5,5,5,0,0,0,9,4,8,4,8,0,0,0,5,5,5,0,0,0,5],
        [3,5,1,0,0,0,0,0,0,0,0,0,2,0,0,0,0,0,0,0,0,0,0,5,4]
    ]
}