{
    "level":11,
    "stage_name": "Python",
    "enemy_count": 20,
    "powerup_req": 1900,
    "tutorial": -1,
    "map": [
        [9,9,9,9,9,9,9,9,9,9,9,9,9,9,9,9,9,0,0,0,9,9,9,9,9],
        [9,9,0,9,9,9,9,9,9,9,9,9,9,9,9,9,9,2,0,9,9,9,9,9,9],
        [9,9,9,0,6,0,0,0,9,9,7,9,9,9,6,9,2,2,9,9,7,0,9,9,0],
        [0,9,9,6,6,0,0,0,0,0,9,9,9,9,9,2,2,9,9,9,7,7,9,9,0],
        [0,9,9,0,2,2,2,2,9,0,0,9,9,9,2,2,9,9,9,2,2,9,9,0,0],
        [9,9,0,2,2,2,2,9,9,0,0,0,0,0,0,9,9,9,0,2,2,9,9,0,0],
        [9,9,0,2,2,2,9,9,0,0,0,5,5,5,0,9,9,0,2,2,2,9,9,9,0],
        [9,9,0,2,2,0,9,9,0,0,0,5,3,5,0,9,9,2,2,2,0,0,9,9,0],
        [9,9,9,7,7,0,9,9,9,0,0,5,5,5,0,9,9,9,0,0,6,6,9,9,0],
        [0,9,9,9,7,7,9,9,9,0,0,0,1,0,0,0,9,9,9,6,6,0,9,9,9],
        [0,9,9,9,0,0,0,9,9,9,0,0,0,0,0,0,0,9,9,0,0,0,0,9,9],
        [9,9,9,0,2,2,2,9,9,9,9,9,9,9,9,9,0,9,9,2,2,2,0,0,9],
        [9,9,9,0,0,0,0,9,9,9,9,9,9,9,9,9,9,9,9,0,0,0,0,0,9],
        [9,9,0,0,6,6,0,9,9,0,0,0,0,0,0,0,9,9,0,7,7,0,0,0,9],
        [9,9,9,2,7,0,2,2,2,0,7,9,9,9,6,0,2,2,2,0,6,2,0,9,9],
        [0,9,9,9,0,9,9,9,9,9,9,9,9,9,9,9,9,9,9,0,0,0,9,9,9],
        [0,9,9,9,9,9,9,9,9,9,9,0,0,0,9,9,9,9,9,9,9,9,9,9,9]
    ]
}