{
    "level":15,
    "stage_name": "CS 12 <3",
    "enemy_count": 20,
    "powerup_req": 2300,
    "tutorial": 0,
    "map": [
        [4,5,0,0,0,0,0,0,0,0,0,0,0,0,0,0,0,0,0,0,0,0,0,5,4],
        [5,0,0,0,0,0,0,0,0,0,0,0,0,0,0,0,0,0,0,0,0,0,0,0,5],
        [0,0,4,0,0,4,0,0,0,0,4,4,0,0,4,0,0,0,4,0,4,4,4,0,0],
        [0,0,4,0,0,4,0,0,0,4,0,0,4,0,4,0,0,0,4,0,4,0,0,0,0],
        [0,0,4,0,0,4,0,0,0,4,0,0,4,0,0,4,0,4,0,0,4,4,4,0,0],
        [0,0,4,0,0,4,0,0,0,4,0,0,4,0,0,4,0,4,0,0,4,0,0,0,0],
        [0,0,4,0,0,4,4,4,0,0,4,4,0,0,0,0,4,0,2,0,4,4,4,0,0],
        [0,2,0,0,0,0,0,0,0,0,0,0,0,0,2,0,0,0,0,0,0,0,0,0,0],
        [0,0,0,0,0,2,0,0,0,0,0,0,0,0,0,0,0,0,0,0,2,0,0,0,0],
        [0,0,0,0,0,0,0,0,0,0,0,0,0,0,0,0,0,0,0,0,0,0,0,0,0],
        [0,0,0,4,4,4,4,0,4,4,4,4,0,0,4,4,0,4,4,4,4,4,0,0,0],
        [0,0,0,4,0,0,0,0,4,0,0,0,0,0,0,4,0,0,0,0,0,4,0,0,0],
        [0,0,0,4,0,0,0,0,4,4,4,4,0,2,0,4,0,4,4,4,4,4,0,0,0],
        [0,0,0,4,0,0,0,0,0,0,0,4,0,0,0,4,0,4,0,0,0,0,2,0,0],
        [0,0,0,4,4,4,4,0,4,4,4,4,0,0,0,4,0,4,4,4,4,4,0,0,0],
        [5,0,0,0,2,0,0,0,0,0,0,0,2,0,0,0,0,0,0,0,0,0,0,0,5],
        [3,5,1,0,0,0,0,0,0,0,0,0,0,0,0,0,0,0,2,0,0,0,0,5,4]
    ]
}