{
    "level":9,
    "stage_name": "Mirror II",
    "enemy_count": 12,
    "powerup_req": 1200,
    "tutorial": 3,
    "map": [
        [4,6,2,2,2,2,2,2,2,2,2,2,2,2,2,2,2,2,2,2,2,2,2,7,4],
        [6,0,2,2,2,2,2,2,2,2,2,2,2,2,2,2,2,2,2,2,2,2,2,0,7],
        [0,0,0,0,0,0,0,0,0,4,4,4,4,4,4,4,0,0,0,0,0,0,0,0,0],
        [0,0,0,5,5,5,0,0,0,0,0,0,0,0,0,0,0,0,0,5,5,5,0,0,0],
        [5,5,0,5,6,5,0,0,0,0,0,0,0,0,0,0,0,0,0,5,7,5,0,5,5],
        [0,0,0,5,5,5,0,0,0,0,0,0,0,0,0,0,0,0,0,5,5,5,0,0,0],
        [0,0,0,0,0,0,0,0,0,0,0,0,0,0,0,0,0,0,0,0,0,0,0,0,0],
        [0,0,0,0,0,0,0,0,0,0,0,0,0,0,0,0,0,0,0,0,0,0,0,0,0],
        [5,5,0,0,0,0,0,0,0,0,0,0,1,0,0,0,0,0,0,0,0,0,0,5,5],
        [0,0,0,0,0,0,0,0,0,0,0,0,0,0,0,0,0,0,0,0,0,0,0,0,0],
        [0,0,0,0,0,0,0,0,0,0,0,0,0,0,0,0,0,0,0,0,0,0,0,0,0],
        [0,0,0,5,5,5,0,0,0,0,0,0,0,0,0,0,0,0,0,5,5,5,0,0,0],
        [5,5,0,5,7,5,0,0,0,0,0,0,0,0,0,0,0,0,0,5,6,5,0,5,5],
        [0,0,0,5,5,5,0,0,0,0,0,0,0,0,0,0,0,0,0,5,5,5,0,0,0],
        [0,0,0,0,0,0,0,0,0,4,4,4,4,4,4,4,0,0,0,0,0,0,0,0,0],
        [7,0,2,2,2,2,2,2,2,2,2,2,2,2,2,2,2,2,2,2,2,2,2,0,6],
        [4,7,2,2,2,2,2,2,2,2,2,2,2,2,2,2,2,2,2,2,2,2,2,6,4]
    ]
}