{
    "level":12,
    "stage_name": "Not Battle City",
    "enemy_count": 20,
    "powerup_req": 2150,
    "tutorial": -1,
    "map": [
        [2,2,2,0,0,0,0,0,0,0,0,2,2,2,0,0,0,0,0,0,0,0,2,2,2],
        [0,2,2,0,0,0,0,0,0,0,2,2,2,2,2,0,0,0,0,0,0,0,2,2,0],
        [0,5,5,0,0,5,5,0,0,5,5,0,0,0,5,5,0,0,5,5,0,0,5,5,0],
        [0,5,5,0,0,5,5,0,0,5,5,4,4,4,5,5,0,0,5,5,0,0,5,5,0],
        [0,5,5,0,0,5,5,0,0,5,5,4,4,4,5,5,0,0,5,5,0,0,5,5,0],
        [0,5,5,0,0,5,5,0,0,5,5,0,0,0,5,5,0,0,5,5,0,0,5,5,0],
        [0,5,5,0,0,5,5,0,0,0,0,0,0,0,0,0,0,0,5,5,0,0,5,5,0],
        [0,0,0,0,0,0,0,0,0,5,5,0,0,0,5,5,0,0,0,0,0,0,0,0,0],
        [5,4,0,5,5,5,5,0,0,0,0,0,0,0,0,0,0,0,5,5,5,5,0,4,5],
        [0,0,0,0,0,0,0,0,0,5,5,0,0,0,5,5,0,0,0,0,0,0,0,0,0],
        [0,5,5,0,0,5,5,0,0,5,5,5,5,5,5,5,0,0,5,5,0,0,5,5,0],
        [0,5,5,0,0,5,5,0,0,5,5,5,5,5,5,5,0,0,5,5,0,0,5,5,0],
        [0,5,5,0,0,5,5,0,0,5,5,0,0,0,5,5,0,0,5,5,0,0,5,5,0],
        [0,5,5,0,0,5,5,0,0,5,5,0,0,0,5,5,0,0,5,5,0,0,5,5,0],
        [0,5,5,0,0,5,5,0,0,0,0,0,1,0,0,0,0,0,5,5,0,0,5,5,0],
        [0,0,0,0,0,0,0,0,0,0,0,5,5,5,0,0,0,0,0,0,0,0,0,0,0],
        [0,0,0,0,0,0,0,0,0,0,0,5,3,5,0,0,0,0,0,0,0,0,0,0,0]
    ]
}