{
    "level":1,
    "stage_name": "Walls II",
    "enemy_count": 5,
    "powerup_req": 500,
    "tutorial": 1,
    "map": [
        [2,2,2,0,0,0,0,0,0,0,0,0,4,0,0,0,0,0,0,0,0,0,2,2,2],
        [2,2,2,0,0,0,0,0,0,0,0,0,4,0,0,0,0,0,0,0,0,0,2,2,2],
        [2,2,2,0,0,0,4,0,0,4,0,0,0,0,0,4,0,0,4,0,0,0,2,2,2],
        [2,2,2,0,0,0,4,0,0,0,0,0,4,0,0,0,0,0,4,0,0,0,2,2,2],
        [2,2,2,0,0,0,4,0,0,0,0,0,4,0,0,0,0,0,4,0,0,0,2,2,2],
        [2,2,2,0,0,0,4,0,0,0,0,0,0,0,0,0,0,0,4,0,0,0,2,2,2],
        [2,2,2,0,0,0,0,0,0,0,0,0,0,0,0,0,0,0,0,0,0,0,2,2,2],
        [2,2,2,0,0,0,0,0,0,0,0,0,0,0,0,0,0,0,0,0,0,0,2,2,2],
        [2,2,2,0,0,0,4,0,0,0,0,0,1,0,0,0,0,0,4,0,0,0,2,2,2],
        [2,2,2,0,0,0,0,0,0,0,0,0,0,0,0,0,0,0,0,0,0,0,2,2,2],
        [2,2,2,0,0,0,0,0,0,0,0,0,0,0,0,0,0,0,0,0,0,0,2,2,2],
        [2,2,2,0,0,0,4,0,0,0,0,0,0,0,0,0,0,0,4,0,0,0,2,2,2],
        [2,2,2,0,0,0,4,0,0,0,0,0,4,0,0,0,0,0,4,0,0,0,2,2,2],
        [2,2,2,0,0,0,4,0,0,0,0,0,4,0,0,0,0,0,4,0,0,0,2,2,2],
        [2,2,2,0,0,0,4,0,0,4,0,0,0,0,0,4,0,0,4,0,0,0,2,2,2],
        [2,2,2,0,0,0,0,0,0,0,0,0,4,0,0,0,0,0,0,0,0,0,2,2,2],
        [2,2,2,0,0,0,0,0,0,0,0,0,4,0,0,0,0,0,0,0,0,0,2,2,2]
    ]
}